10.ox
..........
..o..o....
o....o....
..........
..oo......
..........
..........
..........
......o...
.......1..
